...###
..##.#.@###
.##..###..#
##........#
###....#..#
###..###..#
..#..#....#
.##.##.#.##
.#......##
.#.....##
...